필요에 의해 만들어지고 목적성에 맞춰서 설계되었기 때문에 AI는 외울 필요 없이 원리만 이해하고 넘어가기
개념들을 연결시켜 새로운 개념을 만들어내거나 논리적으로 풀어가는 방법

빅데이터 = volume(규모) + velocity(속도) + variety(다양성)
    속도 -> data는 수명이 있기 때문에 적시에 빠르게 수집하고 인사이트를 내야 됨

다크 data : 빅데이터 중 사용할 수 없는 data

structured data : 숫자, 행과 열로 이루어져 있음
unstructured data : 대부분 data 형식, 동영상, sns 사진, 자연어 data 
    -> 모든 data는 알고리즘에 넣기 위해 숫자로 치환해야 됨. 숫자만 보고 직관적으로 data가 무엇인지 알 수 없음
semi-structured data : 크롤링한 data(html 규칙에 따름)

전처리 = unstructured data -> structured data : 정규표현식 등을 통해 필요한 data를 뽑아내는 과정

인공지능
    연산능력 : 단순 계산, 제어(계산기, 세탁기 등)
    판단능력 : 조건에 따라 정해진 것 중 선택(진단, 퍼즐 등)
    추론능력 : data로부터 예측/추론(머신러닝)
    학습능력 : 학습을 통해 진화(딥러닝)
    창의력 : 새로운 것을 만듬(초 인공지능)

머신러닝 척도 -> 머신러닝으로 만들기 위해서는 4가지 척도로 변환 필요(딥러닝에서는 사용하지 않음)
    명목 : 임의로 나눈 척도(성별)
    서열 : 순서가 있음
    등간 : 덧셈, 뺄셈이 가능(온도, 시간)
    비율 : 곱셈, 나눗셈 가능(무게, 길이)

딥러닝
    GAN
        이미지를 숫자로 1차 변환, 숫자를 다시 이미지로 변환 -> 처음에는 잘 안맞다가 맞을 때가지 여러번 돌림 
        -> 그림을 가장 잘 설명하는 숫자를 찾아냄 

    알파고 : 강화학습 -> 시뮬레이션
        ** 인공지능 알고리즘을 만들기 위해서는 변수가 어느정도 예측 가능해야 하고 보상이 명확해야 함
        게임 같은 경우 보상이 애매하기 때문에(도중에 나가면 피드백이 어렵기 때문에)
        스타가 안되면 롤은 가능?? 5개 챔프 다 조종 가능??(스킬 다 피하는 핵이 지금 있는데)

아이작 아시모프 로봇 3원칙(1942년)
AI설계할 때 고려해야할 요소 : FAT